000000000000000
0g0g00ggg00g0g0
0g0g00g0g00g0g0
00g000g0g00g0g0
00g000ggg00ggg0
000000000000000
0g0g0g0g0gg00g0
0g0g0g0g0g0g0g0
00ggg00g0g00gg0
0000000p0000000
