00000000000000e
0gbgg0d0d0ggbg0
0gggd0b0b0dggg0
0ggg00d0d00ggg0
0ggd0dg0gd0dgg0
0gg00dg0gd00gg0
0gd0dgg0ggd0dg0
0g00bgg0ggb00g0
0g0gggg0gggg0g0
0000000p0000000
